XXXOXXOXX---
------------
------------
--------O---
------------
--O-O-O-O---
---O--------
------------
------------
------------
------------
------------